---77777777---
---77777777---
--------------
11111111111111
11111111111111
11----------11
11111111111111
11111111111111
--------------
---45455454---
---78788787---
